//MAP CONVERTED BY dmm2tgm.py THIS HEADER COMMENT PREVENTS RECONVERSION, DO NOT REMOVE
"a" = (
/turf/open/misc/dirt,
/area/vtm/interior/sewer)
"b" = (
/obj/structure/platform/lowwall/brick_old,
/obj/item/clothing/head/vampire/skull{
	pixel_x = -6;
	pixel_y = 9
	},
/turf/open/floor/plating/rough/cave,
/area/vtm/interior/sewer)
"c" = (
/obj/effect/decal/remains/human,
/turf/open/floor/plating/rough/cave,
/area/vtm/interior/sewer)
"d" = (
/obj/item/storage/belt/sheath/vamp/sabre{
	pixel_x = -3
	},
/turf/open/floor/plating/rough/cave,
/area/vtm/interior/sewer)
"h" = (
/obj/structure/platform/lowwall/brick_old,
/obj/item/coin/gold/doubloon,
/turf/open/floor/plating/rough/cave,
/area/vtm/interior/sewer)
"j" = (
/obj/fake_sarcophagus,
/turf/open/floor/plating/rough/cave,
/area/vtm/interior/sewer)
"k" = (
/turf/closed/wall/vampwall/brick_old,
/area/vtm/interior/sewer)
"l" = (
/obj/effect/decal/cleanable/rubble,
/turf/open/floor/plating/rough/cave,
/area/vtm/interior/sewer)
"m" = (
/obj/item/clothing/head/vampire/skull,
/obj/structure/platform/lowwall/brick_old,
/turf/open/floor/plating/rough/cave,
/area/vtm/interior/sewer)
"p" = (
/obj/structure/platform/lowwall/brick_old,
/obj/effect/mob_spawn/corpse/human/skeleton,
/turf/open/floor/plating/rough/cave,
/area/vtm/interior/sewer)
"q" = (
/obj/structure/vampdoor/old,
/turf/open/floor/plating/rough/cave,
/area/vtm/interior/sewer)
"r" = (
/obj/modular_map_connector,
/turf/open/misc/dirt,
/area/vtm/interior/sewer)
"t" = (
/turf/open/floor/plating/rough/cave,
/area/vtm/interior/sewer)
"u" = (
/obj/structure/platform/lowwall/brick_old,
/turf/closed/wall/vampwall/rock,
/area/vtm/interior/sewer)
"y" = (
/turf/closed/wall/vampwall/rock,
/area/vtm/interior/sewer)
"z" = (
/obj/structure/flora/rock/stalagmite,
/turf/open/floor/plating/rough/cave,
/area/vtm/interior/sewer)
"A" = (
/obj/structure/platform/lowwall/brick_old,
/obj/item/flashlight/lantern/on{
	pixel_x = 5;
	pixel_y = 4
	},
/turf/open/floor/plating/rough/cave,
/area/vtm/interior/sewer)
"C" = (
/obj/structure/platform/lowwall/wood,
/turf/open/floor/plating/rough/cave,
/area/vtm/interior/sewer)
"D" = (
/obj/structure/platform/lowwall/brick_old,
/obj/item/coin/silver,
/turf/open/floor/plating/rough/cave,
/area/vtm/interior/sewer)
"E" = (
/obj/structure/vampdoor/old{
	dir = 4
	},
/obj/effect/mapping_helpers/door/lock,
/turf/open/floor/plating/rough/cave,
/area/vtm/interior/sewer)
"G" = (
/obj/structure/flora/rock/pile/darkpack,
/turf/open/floor/plating/rough/cave,
/area/vtm/interior/sewer)
"H" = (
/obj/structure/platform/lowwall/brick_old,
/obj/effect/mob_spawn/corpse/human/charredskeleton,
/turf/open/floor/plating/rough/cave,
/area/vtm/interior/sewer)
"K" = (
/obj/effect/decal/cleanable/rubble,
/obj/effect/decal/remains/human,
/turf/open/floor/plating/rough/cave,
/area/vtm/interior/sewer)
"L" = (
/obj/structure/platform/lowwall/brick_old,
/obj/item/flashlight/lantern,
/turf/open/floor/plating/rough/cave,
/area/vtm/interior/sewer)
"N" = (
/obj/structure/ladder/manhole/up{
	requires_friend = 0
	},
/turf/open/floor/plating/rough/cave,
/area/vtm/interior/sewer)
"O" = (
/obj/structure/platform/lowwall/brick_old,
/turf/open/floor/plating/rough/cave,
/area/vtm/interior/sewer)
"P" = (
/obj/structure/vampdoor/old{
	dir = 4
	},
/obj/effect/mapping_helpers/door/lock,
/obj/effect/mapping_helpers/door/lock_difficulty/seven,
/turf/open/floor/plating/rough/cave,
/area/vtm/interior/sewer)
"S" = (
/obj/structure/platform/lowwall/brick_old,
/obj/item/clothing/head/vampire/skull{
	pixel_x = 9;
	pixel_y = 10
	},
/turf/open/floor/plating/rough/cave,
/area/vtm/interior/sewer)
"U" = (
/obj/structure/closet/crate/coffin,
/mob/living/basic/ghost/giovanni,
/turf/open/floor/plating/rough/cave,
/area/vtm/interior/sewer)
"V" = (
/mob/living/basic/szlachta/hostile,
/turf/open/floor/plating/rough/cave,
/area/vtm/interior/sewer)
"W" = (
/obj/structure/barricade/wooden,
/turf/open/floor/plating/rough/cave,
/area/vtm/interior/sewer)
"Z" = (
/obj/structure/platform/lowwall/wood,
/obj/effect/mob_spawn/corpse/human/skeleton,
/turf/open/floor/plating/rough/cave,
/area/vtm/interior/sewer)

(1,1,1) = {"
y
y
y
y
y
y
y
y
y
y
y
y
y
y
y
y
y
y
y
r
"}
(2,1,1) = {"
y
y
a
a
y
y
k
t
U
k
y
y
y
k
y
y
k
y
y
a
"}
(3,1,1) = {"
y
y
a
t
z
k
O
t
t
O
k
l
k
O
t
t
p
k
y
a
"}
(4,1,1) = {"
y
y
a
t
t
l
O
t
t
O
K
t
W
O
t
t
O
y
y
a
"}
(5,1,1) = {"
y
y
G
t
l
k
O
t
t
O
k
G
k
O
t
t
b
k
y
a
"}
(6,1,1) = {"
y
z
t
t
y
y
k
t
c
k
y
y
y
k
c
t
k
y
y
a
"}
(7,1,1) = {"
y
t
t
t
y
k
C
t
t
D
k
y
k
m
t
t
O
k
y
a
"}
(8,1,1) = {"
y
t
t
t
y
y
C
t
t
p
y
y
y
O
t
t
O
y
y
a
"}
(9,1,1) = {"
y
t
t
t
y
k
Z
t
t
O
k
y
k
p
t
t
S
k
y
a
"}
(10,1,1) = {"
G
V
d
V
z
y
k
c
t
k
y
y
y
k
t
t
k
y
y
a
"}
(11,1,1) = {"
t
t
j
t
t
k
h
t
t
p
k
y
k
H
t
t
O
k
y
a
"}
(12,1,1) = {"
z
t
t
t
t
y
O
t
t
O
y
y
y
O
t
t
O
y
y
a
"}
(13,1,1) = {"
y
t
z
t
y
k
p
t
t
O
k
y
k
L
t
t
O
k
y
a
"}
(14,1,1) = {"
y
y
y
y
y
y
k
t
t
k
y
y
y
k
t
t
k
y
y
a
"}
(15,1,1) = {"
y
y
y
y
y
y
y
t
t
y
y
y
y
y
t
t
y
y
y
a
"}
(16,1,1) = {"
y
y
y
y
y
y
y
t
t
y
y
y
y
y
t
t
y
y
y
a
"}
(17,1,1) = {"
y
y
y
z
t
y
y
y
P
k
A
O
O
k
y
E
y
y
y
a
"}
(18,1,1) = {"
y
y
z
N
t
t
t
t
t
t
t
t
t
t
t
t
t
q
l
a
"}
(19,1,1) = {"
y
y
y
t
t
t
t
t
t
t
t
t
t
t
t
t
t
y
y
a
"}
(20,1,1) = {"
y
y
y
y
y
y
y
y
y
k
u
u
u
k
y
y
y
y
y
a
"}
